111111111111
1E001010P111
100F01101111
10000CC01111
111111111111
