111111111111
1P00000000C1
111111111101
1E00000000C1
111111111111
